appraise : estimer, évaluer
substantiate : prouver, justifier, accréditer
dig : fouiller, creuser, bêcher.
the root : racine, cause, origine
insight : perspicacité, pénétration, aperçu.
draw up : rediger
draw nearer : se rapprocher
draw : étirer, toucher, prélever, dessiner, attirer
shed : répandre, étendre
fool : idiot, imbécile, sot, dupe (Verbe : mystifier, berner) to fool about : faire l'idiot, traîner
throw : jeter, lancer, mouiliner (threw, thrown
call off: annuler
do over : repeat
fill out : complete
find out discover
leave out : omit
look over : examine
pass out : distribute
take up : discuss
call on : ask to recite or visit
go over : review
keep on : continue
look into : investigate
run across : discover by chance
un into : meet by chance
break down : stop functioning
come back : return
come over : visit
come to : regain consciousness
get along : progress
pass out : faint; s'évanouir, se pâmer
wear off : s'éffacer, disparaître, dissiper, passer
hell : enfer
bother : ennuyer; gêner, don't bother, déranger
afford: se permettre; avoir des moyen; founir; I can't afford to pay more than 10dollars
elusive : insaisissable; fuyant, évasif
trick:astuce; truc; ruse
ravel: emmêner; embrouiller
unravel:défaire, effiler; éclaircir
blissful:bienheureux; béat
togetherness: unité; camaraderie
worthy:digne; louable
turn out:expulser; déloger;éteindre;vider
fashion : faconner
enforce : appliquer, faire respecter, mettre en vigueur
obediently: docilement
foretell : prédire
gird : ceindre, revêtir
loins : reins 
loin cloth : pagne
throng : foule, multitude; se presser dans; affluer
lane : ruelle, voie, chemin, piste
maim : mutiler (maimed: mutilé)
purses: porte-monnaie, bourse, prix (trésor public : public purse)
stringency: force, resserrement, rigueur.
behold (beheld, beheld) voir, apercevoir, contempler
dreadful: épouvantable, effroyable, effrayant, terrible
earn: gagner; earned income : revenu salarial
lean : amaigri, maigre, pauvre, (v : s'incliner, se pencher, s'appuyer; to lean out : se pencher au dehors
whilst : tandis que
to purchase : acheter, acquérir
bulk : volume; capacité, masse, gros (bulk purchase : achat en gros)
attain : accèder, obtenir, parvenir, atteindre
attainment : réussite, accession, conquête, résultats
proficiency : compétence, aptitude, capacité
misleading : trompeur, (v: égarer, dévoyer, induire en erreur)
knowledgeable : bien informé
knowledgeably : en toute connaissance.
grasp : accrocher, saisir (fully grasp concepts , saisir totalement le sens)